111111111111111111111111111111
1P000000000000000C000000000001
101010101010101010101010101001
100000000000000000000000000001
100C00000000000000000000000001
101010101010101010101010101001
100000000000000000000000000E01
101010101010101010101010101001
100000000000000000000000000001
101010101010101010101010101001
100000000000000000000000000001
100000000000000000000000000C01
101010101010101010101010101001
100000000000000000000000000001
101010101010101010101010101001
100000000000000000000000000001
100000000000000000000000000001
100000000000000000000000000001
100000000000000000000000000001
111111111111111111111111111111
