1111111
1001001
1P01001
10010E1
1000001
1000001
1111111
