1111111111111111111111111111111111111111
1P000000000000000000C0000000000000000001
1010101010101010101010101010101010101011
1000000000000000000000000000000000000001
1000000000000000000000000000000000000001
1010101010101010101010101010101010101011
1000000000000000000000000000000000000001
1000000000000000000000000000000000000001
1010101010101010101010101010101010101011
1000000000000000000000000000000000000001
100C0000000000000000000000000000000000E1
1010101010101010101010101010101010101011
1000000000000000000000000000000000000001
1000000000000000000000000000000000000001
1010101010101010101010101010101010101011
1000000000000000000000000000000000000001
1000000000000000000000000000000000000001
1010101010101010101010101010101010101011
1000000000000000000000000000000000000001
1000000000000000000000000000000000000001
1010101010101010101010101010101010101011
1000000000000000000000000000000000000001
1000000000000000000000000000000000000001
1111111111111111111111111111111111111111
