111111
100001
1P0E01
100001
111111