11111111
11111P11
10000011
1C111111
10000011
1E000011
11111111